k , hk, hok, ko, kg: không
trl, tl: trả lời
cskh: chăm sóc khách hàng
nt: nhắn tin
sp, s.p, s/p: sản phẩm
sdung, sd: sử dụng
sh, shop: cửa hàng
oke, ok, okie, oki: tốt
jong: giống
đc, dc: được
bt: biết / bình thường
đt: điện thoại
SĐT: số điện thoại
r: rồi
best, good: tốt
very: rất
not: không,
ship: vận chuyển
vs: với
max: rất
nch: nói chuyện
noti, notify: thông báo
sms: tin nhắn
tgian, tg: thời gian
pm, ib, inbox: nhắn tin
ngta: người ta
nd: nội dung
lm: làm
qc: quảng cáo
thanks, tks: cảm ơn
real: thật
fake: giả
review: đánh giá
mk, m: mình
comment: ý kiến
value: giá trị
money: tiền
fast: nhanh
delivery: vận chuyển
Excellent: tuyệt vời
service: dịch vụ
seller: người bán
terrible: khủng khiếp
quality: chất lượng
bik: biết
very: rất
j: gì
v: vậy
r: rồi
ng: người
packaging: đóng gói
wa: quá
dk: được
ktra: kiểm tra
speed: nhanh
product: sản phẩm
poor: tệ
app: ứng dụng
sz: size
sales: sale
trc: trước
z: vậy
ae: anh em
thik: thích
hsd: hạn sử dụng
chất lg: chất lượng
mn: mọi người
love: thích
test: kiểm tra
nv giao hàng: nhân viên giao hàng
ksao: không sao
κ: không